"filename", "language", "java", "comment", "blank", "total"
"/home/haoyang/hol_parser/theory_parser/bin/haoyang/HolParser.class", "java", 3, 0, -1, 2
"/home/haoyang/hol_parser/theory_parser/bin/haoyang/test.class", "java", 0, 0, -1, -1
"/home/haoyang/hol_parser/theory_parser/bin/main/java/net/claribole/zgrviewer/AppletUtils.class", "java", -39, 0, -1, -40
"/home/haoyang/hol_parser/theory_parser/bin/main/java/net/claribole/zgrviewer/BaseEventHandler.class", "java", -26, 0, -1, -27
"/home/haoyang/hol_parser/theory_parser/bin/main/java/net/claribole/zgrviewer/BookmarksList.class", "java", -15, 0, -1, -16
"/home/haoyang/hol_parser/theory_parser/bin/main/java/net/claribole/zgrviewer/BroughtEdge.class", "java", -13, 0, -1, -14
"/home/haoyang/hol_parser/theory_parser/bin/main/java/net/claribole/zgrviewer/BroughtElement.class", "java", -11, 0, -1, -12
"/home/haoyang/hol_parser/theory_parser/bin/main/java/net/claribole/zgrviewer/BroughtNode.class", "java", -14, 0, -1, -15
"/home/haoyang/hol_parser/theory_parser/bin/main/java/net/claribole/zgrviewer/CallBox.class", "java", -18, 0, -1, -19
"/home/haoyang/hol_parser/theory_parser/bin/main/java/net/claribole/zgrviewer/ColorIndicator.class", "java", -16, 0, -1, -17
"/home/haoyang/hol_parser/theory_parser/bin/main/java/net/claribole/zgrviewer/ConfigManager.class", "java", -79, 0, -1, -80
"/home/haoyang/hol_parser/theory_parser/bin/main/java/net/claribole/zgrviewer/DOTManager.class", "java", -40, 0, -1, -41
"/home/haoyang/hol_parser/theory_parser/bin/main/java/net/claribole/zgrviewer/DistanceComparator.class", "java", -13, 0, -1, -14
"/home/haoyang/hol_parser/theory_parser/bin/main/java/net/claribole/zgrviewer/FrameDesign.class", "java", -12, 0, -1, -13
"/home/haoyang/hol_parser/theory_parser/bin/main/java/net/claribole/zgrviewer/GVLoader.class", "java", -40, 0, -1, -41
"/home/haoyang/hol_parser/theory_parser/bin/main/java/net/claribole/zgrviewer/GeometryEditor.class", "java", -24, 0, -1, -25
"/home/haoyang/hol_parser/theory_parser/bin/main/java/net/claribole/zgrviewer/GraphicsManager.class", "java", -224, 0, -1, -225
"/home/haoyang/hol_parser/theory_parser/bin/main/java/net/claribole/zgrviewer/LEdge.class", "java", -58, 0, -1, -59
"/home/haoyang/hol_parser/theory_parser/bin/main/java/net/claribole/zgrviewer/LElem.class", "java", -26, 0, -1, -27
"/home/haoyang/hol_parser/theory_parser/bin/main/java/net/claribole/zgrviewer/LGraph.class", "java", -34, 0, -1, -35
"/home/haoyang/hol_parser/theory_parser/bin/main/java/net/claribole/zgrviewer/LNode.class", "java", -49, 0, -1, -50
"/home/haoyang/hol_parser/theory_parser/bin/main/java/net/claribole/zgrviewer/LinkSliderCalc.class", "java", -26, 0, -1, -27
"/home/haoyang/hol_parser/theory_parser/bin/main/java/net/claribole/zgrviewer/LogicalStructure.class", "java", -33, 0, -1, -34
"/home/haoyang/hol_parser/theory_parser/bin/main/java/net/claribole/zgrviewer/Messages.class", "java", -70, 0, -12, -82
"/home/haoyang/hol_parser/theory_parser/bin/main/java/net/claribole/zgrviewer/NavPanel.class", "java", -15, 0, -1, -16
"/home/haoyang/hol_parser/theory_parser/bin/main/java/net/claribole/zgrviewer/PNGExportWindow.class", "java", -26, 0, -1, -27
"/home/haoyang/hol_parser/theory_parser/bin/main/java/net/claribole/zgrviewer/PeriodicActionManager.class", "java", -41, 0, -1, -42
"/home/haoyang/hol_parser/theory_parser/bin/main/java/net/claribole/zgrviewer/Plugin.class", "java", -9, 0, -1, -10
"/home/haoyang/hol_parser/theory_parser/bin/main/java/net/claribole/zgrviewer/PolyLine.class", "java", -38, 0, -1, -39
"/home/haoyang/hol_parser/theory_parser/bin/main/java/net/claribole/zgrviewer/PrefWindow.class", "java", -37, 0, -1, -38
"/home/haoyang/hol_parser/theory_parser/bin/main/java/net/claribole/zgrviewer/PrintUtilities.class", "java", -16, 0, -1, -17
"/home/haoyang/hol_parser/theory_parser/bin/main/java/net/claribole/zgrviewer/PrintWindow.class", "java", -24, 0, -1, -25
"/home/haoyang/hol_parser/theory_parser/bin/main/java/net/claribole/zgrviewer/ProcessOutputConsumer.class", "java", -19, 0, -1, -20
"/home/haoyang/hol_parser/theory_parser/bin/main/java/net/claribole/zgrviewer/RadarEvtHdlr.class", "java", -79, 0, -1, -80
"/home/haoyang/hol_parser/theory_parser/bin/main/java/net/claribole/zgrviewer/Ring.class", "java", -13, 0, -1, -14
"/home/haoyang/hol_parser/theory_parser/bin/main/java/net/claribole/zgrviewer/RingManager.class", "java", -17, 0, -1, -18
"/home/haoyang/hol_parser/theory_parser/bin/main/java/net/claribole/zgrviewer/SearchBox.class", "java", -20, 0, -1, -21
"/home/haoyang/hol_parser/theory_parser/bin/main/java/net/claribole/zgrviewer/SearchPanel.class", "java", -19, 0, -1, -20
"/home/haoyang/hol_parser/theory_parser/bin/main/java/net/claribole/zgrviewer/TextViewer.class", "java", -31, 0, -1, -32
"/home/haoyang/hol_parser/theory_parser/bin/main/java/net/claribole/zgrviewer/ToolPalette.class", "java", -62, 0, -1, -63
"/home/haoyang/hol_parser/theory_parser/bin/main/java/net/claribole/zgrviewer/Utils.class", "java", -31, 0, -1, -32
"/home/haoyang/hol_parser/theory_parser/bin/main/java/net/claribole/zgrviewer/Vector2D.class", "java", -103, 0, -1, -104
"/home/haoyang/hol_parser/theory_parser/bin/main/java/net/claribole/zgrviewer/WebBrowser.class", "java", -11, 0, -1, -12
"/home/haoyang/hol_parser/theory_parser/bin/main/java/net/claribole/zgrviewer/ZGRAGlassPane.class", "java", -15, 0, -1, -16
"/home/haoyang/hol_parser/theory_parser/bin/main/java/net/claribole/zgrviewer/ZGRApplet.class", "java", -53, 0, -1, -54
"/home/haoyang/hol_parser/theory_parser/bin/main/java/net/claribole/zgrviewer/ZGRApplication.class", "java", -8, 0, -1, -9
"/home/haoyang/hol_parser/theory_parser/bin/main/java/net/claribole/zgrviewer/ZGRGlassPane.class", "java", -20, 0, -1, -21
"/home/haoyang/hol_parser/theory_parser/bin/main/java/net/claribole/zgrviewer/ZGROptions.class", "java", -32, 0, -1, -33
"/home/haoyang/hol_parser/theory_parser/bin/main/java/net/claribole/zgrviewer/ZGRPanelViewer.class", "java", -17, 0, -1, -18
"/home/haoyang/hol_parser/theory_parser/bin/main/java/net/claribole/zgrviewer/ZGRViewer.class", "java", -88, 0, -1, -89
"/home/haoyang/hol_parser/theory_parser/bin/main/java/net/claribole/zgrviewer/ZP2LensAction.class", "java", -12, 0, -1, -13
"/home/haoyang/hol_parser/theory_parser/bin/main/java/net/claribole/zgrviewer/ZgrAppletEvtHdlr.class", "java", -62, 0, -1, -63
"/home/haoyang/hol_parser/theory_parser/bin/main/java/net/claribole/zgrviewer/ZgrvEvtHdlr.class", "java", -63, 0, -1, -64
"/home/haoyang/hol_parser/theory_parser/bin/net/claribole/zgrviewer/AppletUtils.class", "java", 62, 0, 0, 62
"/home/haoyang/hol_parser/theory_parser/bin/net/claribole/zgrviewer/BaseEventHandler.class", "java", 47, 0, 0, 47
"/home/haoyang/hol_parser/theory_parser/bin/net/claribole/zgrviewer/BookmarksList$1.class", "java", 18, 0, 0, 18
"/home/haoyang/hol_parser/theory_parser/bin/net/claribole/zgrviewer/BookmarksList$2.class", "java", 12, 0, 0, 12
"/home/haoyang/hol_parser/theory_parser/bin/net/claribole/zgrviewer/BookmarksList.class", "java", 36, 0, 1, 37
"/home/haoyang/hol_parser/theory_parser/bin/net/claribole/zgrviewer/BroughtEdge.class", "java", 26, 0, 1, 27
"/home/haoyang/hol_parser/theory_parser/bin/net/claribole/zgrviewer/BroughtElement.class", "java", 10, 0, 0, 10
"/home/haoyang/hol_parser/theory_parser/bin/net/claribole/zgrviewer/BroughtNode$1.class", "java", 13, 0, 0, 13
"/home/haoyang/hol_parser/theory_parser/bin/net/claribole/zgrviewer/BroughtNode.class", "java", 18, 0, 0, 18
"/home/haoyang/hol_parser/theory_parser/bin/net/claribole/zgrviewer/CallBox$1.class", "java", 14, 0, 0, 14
"/home/haoyang/hol_parser/theory_parser/bin/net/claribole/zgrviewer/CallBox$2.class", "java", 12, 0, 0, 12
"/home/haoyang/hol_parser/theory_parser/bin/net/claribole/zgrviewer/CallBox$3.class", "java", 11, 0, 0, 11
"/home/haoyang/hol_parser/theory_parser/bin/net/claribole/zgrviewer/CallBox.class", "java", 82, 0, 2, 84
"/home/haoyang/hol_parser/theory_parser/bin/net/claribole/zgrviewer/ColorIndicator.class", "java", 15, 0, 0, 15
"/home/haoyang/hol_parser/theory_parser/bin/net/claribole/zgrviewer/ConfigManager$1.class", "java", 10, 0, 0, 10
"/home/haoyang/hol_parser/theory_parser/bin/net/claribole/zgrviewer/ConfigManager$2.class", "java", 11, 0, 1, 12
"/home/haoyang/hol_parser/theory_parser/bin/net/claribole/zgrviewer/ConfigManager.class", "java", 325, 0, 5, 330
"/home/haoyang/hol_parser/theory_parser/bin/net/claribole/zgrviewer/DOTManager.class", "java", 107, 0, 3, 110
"/home/haoyang/hol_parser/theory_parser/bin/net/claribole/zgrviewer/DistanceComparator.class", "java", 13, 0, 0, 13
"/home/haoyang/hol_parser/theory_parser/bin/net/claribole/zgrviewer/FrameDesign.class", "java", 23, 0, 0, 23
"/home/haoyang/hol_parser/theory_parser/bin/net/claribole/zgrviewer/GVLoader$1.class", "java", 14, 0, 0, 14
"/home/haoyang/hol_parser/theory_parser/bin/net/claribole/zgrviewer/GVLoader$2.class", "java", 11, 0, 0, 11
"/home/haoyang/hol_parser/theory_parser/bin/net/claribole/zgrviewer/GVLoader$3.class", "java", 13, 0, 0, 13
"/home/haoyang/hol_parser/theory_parser/bin/net/claribole/zgrviewer/GVLoader$4.class", "java", 12, 0, 0, 12
"/home/haoyang/hol_parser/theory_parser/bin/net/claribole/zgrviewer/GVLoader$5.class", "java", 12, 0, 0, 12
"/home/haoyang/hol_parser/theory_parser/bin/net/claribole/zgrviewer/GVLoader.class", "java", 127, 0, 0, 127
"/home/haoyang/hol_parser/theory_parser/bin/net/claribole/zgrviewer/GeometryEditor.class", "java", 57, 0, 0, 57
"/home/haoyang/hol_parser/theory_parser/bin/net/claribole/zgrviewer/GraphicsManager$1.class", "java", 11, 0, 0, 11
"/home/haoyang/hol_parser/theory_parser/bin/net/claribole/zgrviewer/GraphicsManager$2.class", "java", 12, 0, 1, 13
"/home/haoyang/hol_parser/theory_parser/bin/net/claribole/zgrviewer/GraphicsManager$3.class", "java", 9, 0, 1, 10
"/home/haoyang/hol_parser/theory_parser/bin/net/claribole/zgrviewer/GraphicsManager.class", "java", 576, 0, 2, 578
"/home/haoyang/hol_parser/theory_parser/bin/net/claribole/zgrviewer/LEdge.class", "java", 54, 0, 0, 54
"/home/haoyang/hol_parser/theory_parser/bin/net/claribole/zgrviewer/LElem.class", "java", 20, 0, 0, 20
"/home/haoyang/hol_parser/theory_parser/bin/net/claribole/zgrviewer/LGraph.class", "java", 55, 0, 0, 55
"/home/haoyang/hol_parser/theory_parser/bin/net/claribole/zgrviewer/LNode.class", "java", 41, 0, 0, 41
"/home/haoyang/hol_parser/theory_parser/bin/net/claribole/zgrviewer/LinkSliderCalc.class", "java", 41, 0, 0, 41
"/home/haoyang/hol_parser/theory_parser/bin/net/claribole/zgrviewer/LogicalStructure.class", "java", 152, 0, 1, 153
"/home/haoyang/hol_parser/theory_parser/bin/net/claribole/zgrviewer/Messages.class", "java", 85, 0, 13, 98
"/home/haoyang/hol_parser/theory_parser/bin/net/claribole/zgrviewer/NavPanel$1.class", "java", 15, 0, 0, 15
"/home/haoyang/hol_parser/theory_parser/bin/net/claribole/zgrviewer/NavPanel.class", "java", 97, 0, 0, 97
"/home/haoyang/hol_parser/theory_parser/bin/net/claribole/zgrviewer/PNGExportWindow$1BrowseActionListener.class", "java", 22, 0, 0, 22
"/home/haoyang/hol_parser/theory_parser/bin/net/claribole/zgrviewer/PNGExportWindow$1CancelActionListener.class", "java", 10, 0, 0, 10
"/home/haoyang/hol_parser/theory_parser/bin/net/claribole/zgrviewer/PNGExportWindow$1DPIChangeListener.class", "java", 12, 0, 0, 12
"/home/haoyang/hol_parser/theory_parser/bin/net/claribole/zgrviewer/PNGExportWindow$1ExportActionListener.class", "java", 27, 0, 0, 27
"/home/haoyang/hol_parser/theory_parser/bin/net/claribole/zgrviewer/PNGExportWindow$1TextChangeListener.class", "java", 10, 0, 0, 10
"/home/haoyang/hol_parser/theory_parser/bin/net/claribole/zgrviewer/PNGExportWindow$1UnitActionListener.class", "java", 10, 0, 0, 10
"/home/haoyang/hol_parser/theory_parser/bin/net/claribole/zgrviewer/PNGExportWindow.class", "java", 84, 0, 0, 84
"/home/haoyang/hol_parser/theory_parser/bin/net/claribole/zgrviewer/PeriodicActionManager.class", "java", 66, 0, 0, 66
"/home/haoyang/hol_parser/theory_parser/bin/net/claribole/zgrviewer/Plugin.class", "java", 6, 0, 0, 6
"/home/haoyang/hol_parser/theory_parser/bin/net/claribole/zgrviewer/PolyLine.class", "java", 96, 0, 0, 96
"/home/haoyang/hol_parser/theory_parser/bin/net/claribole/zgrviewer/PrefWindow$1.class", "java", 13, 0, 0, 13
"/home/haoyang/hol_parser/theory_parser/bin/net/claribole/zgrviewer/PrefWindow$2.class", "java", 11, 0, 0, 11
"/home/haoyang/hol_parser/theory_parser/bin/net/claribole/zgrviewer/PrefWindow$3.class", "java", 33, 0, 1, 34
"/home/haoyang/hol_parser/theory_parser/bin/net/claribole/zgrviewer/PrefWindow$4.class", "java", 9, 0, 0, 9
"/home/haoyang/hol_parser/theory_parser/bin/net/claribole/zgrviewer/PrefWindow$5.class", "java", 15, 0, 1, 16
"/home/haoyang/hol_parser/theory_parser/bin/net/claribole/zgrviewer/PrefWindow$6.class", "java", 11, 0, 1, 12
"/home/haoyang/hol_parser/theory_parser/bin/net/claribole/zgrviewer/PrefWindow.class", "java", 340, 0, 7, 347
"/home/haoyang/hol_parser/theory_parser/bin/net/claribole/zgrviewer/PrintUtilities.class", "java", 44, 0, 0, 44
"/home/haoyang/hol_parser/theory_parser/bin/net/claribole/zgrviewer/PrintWindow$1CancelActionListener.class", "java", 10, 0, 0, 10
"/home/haoyang/hol_parser/theory_parser/bin/net/claribole/zgrviewer/PrintWindow$1DPIChangeListener.class", "java", 12, 0, 0, 12
"/home/haoyang/hol_parser/theory_parser/bin/net/claribole/zgrviewer/PrintWindow$1ExportActionListener.class", "java", 21, 0, 0, 21
"/home/haoyang/hol_parser/theory_parser/bin/net/claribole/zgrviewer/PrintWindow$1TextChangeListener.class", "java", 10, 0, 0, 10
"/home/haoyang/hol_parser/theory_parser/bin/net/claribole/zgrviewer/PrintWindow$1UnitActionListener.class", "java", 10, 0, 0, 10
"/home/haoyang/hol_parser/theory_parser/bin/net/claribole/zgrviewer/PrintWindow.class", "java", 76, 0, 0, 76
"/home/haoyang/hol_parser/theory_parser/bin/net/claribole/zgrviewer/ProcessOutputConsumer.class", "java", 28, 0, 0, 28
"/home/haoyang/hol_parser/theory_parser/bin/net/claribole/zgrviewer/RadarEvtHdlr.class", "java", 72, 0, 0, 72
"/home/haoyang/hol_parser/theory_parser/bin/net/claribole/zgrviewer/Ring.class", "java", 9, 0, 0, 9
"/home/haoyang/hol_parser/theory_parser/bin/net/claribole/zgrviewer/RingManager.class", "java", 17, 0, 0, 17
"/home/haoyang/hol_parser/theory_parser/bin/net/claribole/zgrviewer/SearchBox$1.class", "java", 12, 0, 0, 12
"/home/haoyang/hol_parser/theory_parser/bin/net/claribole/zgrviewer/SearchBox.class", "java", 36, 0, 0, 36
"/home/haoyang/hol_parser/theory_parser/bin/net/claribole/zgrviewer/SearchPanel.class", "java", 31, 0, 0, 31
"/home/haoyang/hol_parser/theory_parser/bin/net/claribole/zgrviewer/TextViewer$1.class", "java", 13, 0, 0, 13
"/home/haoyang/hol_parser/theory_parser/bin/net/claribole/zgrviewer/TextViewer$2.class", "java", 15, 0, 0, 15
"/home/haoyang/hol_parser/theory_parser/bin/net/claribole/zgrviewer/TextViewer$3.class", "java", 13, 0, 0, 13
"/home/haoyang/hol_parser/theory_parser/bin/net/claribole/zgrviewer/TextViewer$4.class", "java", 15, 0, 0, 15
"/home/haoyang/hol_parser/theory_parser/bin/net/claribole/zgrviewer/TextViewer.class", "java", 86, 0, 0, 86
"/home/haoyang/hol_parser/theory_parser/bin/net/claribole/zgrviewer/ToolPalette.class", "java", 117, 0, 0, 117
"/home/haoyang/hol_parser/theory_parser/bin/net/claribole/zgrviewer/Utils.class", "java", 92, 0, 1, 93
"/home/haoyang/hol_parser/theory_parser/bin/net/claribole/zgrviewer/Vector2D.class", "java", 86, 0, 0, 86
"/home/haoyang/hol_parser/theory_parser/bin/net/claribole/zgrviewer/WebBrowser.class", "java", 26, 0, 1, 27
"/home/haoyang/hol_parser/theory_parser/bin/net/claribole/zgrviewer/ZGRAGlassPane$1.class", "java", 8, 0, 0, 8
"/home/haoyang/hol_parser/theory_parser/bin/net/claribole/zgrviewer/ZGRAGlassPane$2.class", "java", 8, 0, 0, 8
"/home/haoyang/hol_parser/theory_parser/bin/net/claribole/zgrviewer/ZGRAGlassPane$3.class", "java", 8, 0, 0, 8
"/home/haoyang/hol_parser/theory_parser/bin/net/claribole/zgrviewer/ZGRAGlassPane.class", "java", 31, 0, 0, 31
"/home/haoyang/hol_parser/theory_parser/bin/net/claribole/zgrviewer/ZGRApplet$1.class", "java", 29, 0, 1, 30
"/home/haoyang/hol_parser/theory_parser/bin/net/claribole/zgrviewer/ZGRApplet.class", "java", 151, 0, 0, 151
"/home/haoyang/hol_parser/theory_parser/bin/net/claribole/zgrviewer/ZGRApplication.class", "java", 5, 0, 0, 5
"/home/haoyang/hol_parser/theory_parser/bin/net/claribole/zgrviewer/ZGRGlassPane$1.class", "java", 8, 0, 0, 8
"/home/haoyang/hol_parser/theory_parser/bin/net/claribole/zgrviewer/ZGRGlassPane$2.class", "java", 8, 0, 0, 8
"/home/haoyang/hol_parser/theory_parser/bin/net/claribole/zgrviewer/ZGRGlassPane$3.class", "java", 8, 0, 0, 8
"/home/haoyang/hol_parser/theory_parser/bin/net/claribole/zgrviewer/ZGRGlassPane.class", "java", 40, 0, 0, 40
"/home/haoyang/hol_parser/theory_parser/bin/net/claribole/zgrviewer/ZGROptions.class", "java", 32, 0, 0, 32
"/home/haoyang/hol_parser/theory_parser/bin/net/claribole/zgrviewer/ZGRPanelViewer.class", "java", 14, 0, 0, 14
"/home/haoyang/hol_parser/theory_parser/bin/net/claribole/zgrviewer/ZGRViewer$1.class", "java", 98, 0, 1, 99
"/home/haoyang/hol_parser/theory_parser/bin/net/claribole/zgrviewer/ZGRViewer$2.class", "java", 8, 0, 0, 8
"/home/haoyang/hol_parser/theory_parser/bin/net/claribole/zgrviewer/ZGRViewer$3.class", "java", 9, 0, 0, 9
"/home/haoyang/hol_parser/theory_parser/bin/net/claribole/zgrviewer/ZGRViewer$4.class", "java", 8, 0, 0, 8
"/home/haoyang/hol_parser/theory_parser/bin/net/claribole/zgrviewer/ZGRViewer.class", "java", 224, 0, 6, 230
"/home/haoyang/hol_parser/theory_parser/bin/net/claribole/zgrviewer/ZP2LensAction.class", "java", 15, 0, 0, 15
"/home/haoyang/hol_parser/theory_parser/bin/net/claribole/zgrviewer/ZgrAppletEvtHdlr.class", "java", 178, 0, 1, 179
"/home/haoyang/hol_parser/theory_parser/bin/net/claribole/zgrviewer/ZgrvEvtHdlr$1.class", "java", 36, 0, 0, 36
"/home/haoyang/hol_parser/theory_parser/bin/net/claribole/zgrviewer/ZgrvEvtHdlr$2.class", "java", 37, 0, 1, 38
"/home/haoyang/hol_parser/theory_parser/bin/net/claribole/zgrviewer/ZgrvEvtHdlr.class", "java", 225, 0, 1, 226
"/home/haoyang/hol_parser/theory_parser/src/haoyang/FileReader.java", "java", -57, 57, 0, 0
"/home/haoyang/hol_parser/theory_parser/src/haoyang/GraphTools.java", "java", -61, 61, 0, 0
"/home/haoyang/hol_parser/theory_parser/src/haoyang/GraphUtil.java", "java", -10, 10, 0, 0
"/home/haoyang/hol_parser/theory_parser/src/haoyang/HolParser.java", "java", -3, 3, 0, 0
"/home/haoyang/hol_parser/theory_parser/src/haoyang/Theory.java", "java", -11, 11, 0, 0
"/home/haoyang/hol_parser/theory_parser/src/haoyang/TheoryParser.java", "java", -61, 61, 0, 0
"/home/haoyang/hol_parser/theory_parser/src/haoyang/ThreadControl.java", "java", -5, 5, 0, 0
"/home/haoyang/hol_parser/theory_parser/src/haoyang/UnusedSearch.java", "java", -2, 2, 0, 0
"/home/haoyang/hol_parser/theory_parser/src/haoyang/test.java", "java", -4, 4, 0, 0
"Total", "-", 3021, 214, -10, 3225